11111111111111
100100C0000C01
10100111110001
1P0011E00000C1
11111111111111

